거슬리	거슬리다
괜찮	괜찮다
귀엽	귀엽다
귀찮	귀찮다
나	나다
놀라	놀라다
되	되다
많	많다
반하	반하다
비싸	비싸다
빠르	빠르다
쉽	쉽다
심하	심하다
싸	싸다
안되	안되다
약하	약하다
엄청나	엄청나다
없	없다
울리	울리다
예쁘	예쁘다
이쁘	이쁘다
있	있다
작	작다
잘되	잘되다
적	적다
좋	좋다
착하	착하다
크	크다
편하	편하다
하	하다
힘들	힘들다
